PrefixName	SuffixName	ThirdName	
String	String	String	
司徒	支邑	斌	
上将	余乾 	莹	
都督	贲绯 	妍	
侍中	鸣	慕凤	
武神	豪	不	
武痴	二巫	剑	
恶来	愁茗	太	
鬼才	叔一	笑	
凤雏	颖方	逊	
武圣	嫣诸	蹇	
上将	无颜	元	
锦帆	涔千	愁	
刺虎	邓酬	海	
卧龙	摇伽	孙	
天辨	成败	敏	
军师	萧冥	幽	
小兵	盈乔	天	
虎豹	问芫	尉	
飞熊	迟紊	莫	
白马	言	柳剑	
蛮夷	稚晴	朱	
卫尉	臻菲	鹰	
骠骑	卜复	栝	
车骑	莆单	忘	
镇东	幽忘	樱	
镇西	士萧	凤	
镇北	姚山	河	
镇南	无色	燕	
征西	凡姑	英	
征北	东方	鞯	
征南	冰叶	颜	
征东	珩尤	姝	
骁骑	严青	荧	
伏波	顾危	成	
偏将	珠中	杭	
太师	道男	亚	
太傅	周天	仇	
少保	若颜	邵	
学士	半邪	苑	
尚书	睐世	倌	
太史	小人	小	
太尉	龙梦	琪	
左徒	鬼神	之	
从事	桃秋	慕	
教头	青岩	尔	
校尉	半山	岚	
巡抚	初连	夏	
太守	碧菡	沛	
司马	伯云	傲	
御史	珊天	满	
丞相	曼文	傥	
提辖	乐奄	菱	
刺史	文一	惜	
郡主	江香	寒	
令尹	周新	醉蓝	
都统	老头	柔	
都尉	语飞	蓉	
虎将	扬安	英海	
龙将	乞蓉	语琴	
文将	箴水	柏	
都爵	桃	涵	
			
			